111111111111
1P0000000101
100C0C0C1C11
111110000111
1000000001E1
111111111111