111111111111
1P0000000011
100C0C0C1C11
111110000111
1000000000E1
111111111111