1111111111111
10010000000C1
1011011C11P01
111E111000C01
1111111111111