1111111111111
1E0100C000C11
1100011111001
1P000C1000001
1111111111111