1111111111
100P000001
10000C0001
1111110E01
1111111111