1111111111111
1E01001000111
1P00011111001
11000C1000P01
1111111111111