
111111
10P001
100001
11E111
1C0111
111111