111111
100C01
1P0011
100E11
111111